%###########################
############################
############################
#            ##            #
# #### ##### ## ##### #### #
# #### #...# ## #...# #### #
# #### ###.# ## ###.# #### #
#                          #
# #### ## #.###### ## #### #
# #### ## ######## ## #### #
#      ##    ##    ##      #
###### ##### ## ##### ######
###### ##### ## ##### ######
###### ##          ## ######
###### ## ###. ### ## ######
###### ## #      # ## ######
###### ## # .... # ## ######
###### ## #      # ## ######
###### ## #.. ...# ## ######
###### ##          ## ######
###### ## #......# ## ######
###### ## ###....# ## ######
#            #.            #
# #### ##### #. ..### #### #
# #### ##### ## ##### #### #
#   ##                ##   #
### ## ## ######## ## ## ###
### ## ## ######## ## ## ###
#      ##    ##    ##      #
# ########## ## ########## #
# ########## ## ########## #
#                          #
############################
############################
############################