%...........................
............................
.############..#######......
#            ##            .
# #### ##### ## ##### #... .
# #### ##### ## #...# #..# #
# #### ##### ## #...# #..# #
#                          #
# #### ## ######.. .# #..# #
# #### ## ###..... .# #### #
#      ##    #.    .#      #
###### ##### #. ....# ######
###### ##### #. ###.# ######
###### ##          ## ######
###### ## ####..## ## ######
###### ## #......# ## ######
          #......#          
###### ## #......# ## ######
###### ## ######## ## ######
###### ##          ## ######
###### ## ######## .# ######
###### ## ###..... .# ######
#            #.            #
# #### ##### #. ....# #### #
# #### ##### ## ##### #### #
#   ##                ##   #
### ## ## ######## ## ## ###
### ## ## ######## ## ## ###
#      ##    ##    ##      #
# ########## ## ########## #
# ########## ## ########## #
#                          #
############################
############################
############################