%##################
#   # ##          #
# # #    ##### ## #
# # # ## #     ## #
#     ## # ###    #
# # # ## #     ## #
# # #    ##### ## #
# # # ##          #
#   #### ##### ## #
# # #    #        #
#   # ## # ### ## #
# # # ## #  #  ## #
# # # ## ##### ## #
#   # ##       ## #
# # # ### ### ### #
#   # ### ### ### #
# # #     ###     #
# # # ### ### ### #
# # # ### ### ### #
#   # ##       ## #
# # # ## # # # ## #
# # # ## # # # ## #
#   #             #
###################