%......###########...........
.  !  _      o ooo       !  .
. . . ._#_# #o#_#o#.... . . .
. . . ....# #o# #o#.... . . .
. . . ....# #o# #o#.... . . .
. . . ....# #!#!#o#.... . . .
. . . ....# #o#_#o#.... . . .
. . . ....# # #X#o#.... . . .
. . . ....# # #o#o#.... . . .
. . . ....# # #o#o#.... . . .
. . . ....# # #o#o#.... . . .
.     ...._   _ooo_....     .
...........###.###...........